10 10
7 0
1 9
2 2 2 1 1 1 1 4 2 2 
2 2 2 1 1 1 1 3 2 2 
1 1 1 1 1 1 3 3 2 2 
3 3 3 3 3 1 3 2 2 2 
3 1 1 1 3 3 3 2 2 2 
3 3 3 1 1 1 1 1 2 2 
1 1 3 1 1 1 1 1 1 2 
1 1 3 1 1 1 1 1 1 2 
1 1 3 1 1 1 1 1 1 1 
1 5 3 1 1 1 1 1 1 1 
7 0 7 1 7 2 6 2 6 3 6 4 5 4 4 4 4 3 3 3 2 3 1 3 0 3 0 4 0 5 1 5 2 5 2 6 2 7 2 8 2 9 1 9 
